GGGGGGGGGGGGGGGGGSSSSSGGGGGGGGGGGGGGGGGGGGGGGGGGGG
GGGGGGGGGGGGGGGGGSSSSSGGGGGGGGGGGGGGGGGGGGGGGGGGGG
GGGGGGGGFGGGGGGGGSSSSSGGGGGGGGGGGGGGGGGGGGGGGGGGGG
GGGGGGGGGGGGGGGGGSSSSSSSSSSSSSSSSSSSGGGGGGGGGGGGGG
GGGGGGGGGGGGGGGGGSSSSSSSSSSSSSSSSSSSGGGGGGGGGGGGGG
GGGGGGGGGGGGGGGGGSSSSSSSSSSSSSSSSSSSGGGGGGGGGGGGGG
GGGGGGGGGFGGGGGGGGGGGGGGGGGGGGGSSSSSGGGGGGGGGGFGGG
GGGGGGGGGGGGGGGGGGGGGGGGGGGGGGGSSSSSGGGGGGGGGGGGGG
GGGGGGGGGGGGGGGGGGGGGGGGGGGGGGGSSSSSGGGGGGGGGGGGGG
GGGGGGGGGGGGGGGGGGGGGGGGGGGGGGGSSSSSGGGGGGGGFGGGGG
SSSSSSSSSSSSSSSSSSSSSSSSSSSSSSSSSSSSGGGGGGGGGGGGGG
SSSSSSSSSSSSSSSSSSSSSSSSSSSSSSSSSSSSGGGGGGGGGGGGGG
SSSSSSSSSSSSSSSSSSSSSSSSSSSSSSSSSSSSGGGGGGGGGGGGGG
GGGGGGGGGGGGGGGGGGGGGGGGGGGGGGGSSSSSGGGGGGGGGGGGGG
GGGGGGGGFGGGGGGGGGGGGGGGGGGGGGGSSSSSGGGGGGGGGGGGGG
GGGGGGGGGGGGGGGGGGGGGGGGGGGGGGGSSSSSGGGGGGGGGGGGGG
GGGGGGGGGGGGGGGGGGGFGGGGGGGGGGGSSSSSSSSSSSSSSSSSSS
GGGGGGGGGGGGGGGGGGGGGGGGGGGGGGGSSSSSSSSSSSSSSSSSSS
GGGGGGGGGGGGGGGGGGGGGGGGGGGGGGGSSSSZSSSSSSSSSSSSSS
GGGGGGGGGGGGGGGGGGGGGGGGGGGGGGGSSSSSGGGGGGGGGGGGGG
GGGGGGGGGGGGGGGGGGGGGGGGGGGGGGGSSSSSGGGGGGGGGGGGGG
GGGGGGGGGGGGGGGGGGGGGGGGGGGGGGGSSSSSGGGGGGGGGGGGGG
GGGGGGGGGFGGGGGGGGGGGGGGGGGGGGGSSSSSGGGGGGGGGGGGGG
GGGGGGGGGGGGGGGGGGGGGGGGGGGGGGGSSSSSGGGGGGGGGGGGGG
SSSSSSSSSSSSSSSSSSSSSSSSSSSSSSSSSSSSGGGGGGGGGGGGGG
SSSSSSSSSSSSSSSSSSSSSSSSSSSSSSSSSSSSGGGGGGGGGGGGGG
SSSSSSSSSSSSSSSSSSSSSSSSSSSSSSSSSSSSGGGGGGGGGGGGGG
GGGGGGGGGGGGGSSSSSGGGGGGGGGGGGGSSSSSGGGGGGGGGGGGGG
GGGGGGGGGGGGGSSSSSGGGGGFGGGGGGGSSSSSGGGGGGGGGGGGGG
GGGGGGGGGGGGGSSSSSGGGGGGGGGGGGGSSSSSGGGGGGGGGGGGGG
GGGGGGGGGGGGGSSSSSGGGGGGGGGGGGGSSSSSGGGGGGGGGGGGGG
GGGGGGFGGGGGGSSSSSGGGGGGGGGGGGGSSSSSGGGGGGFGGGGGGG
GGGGGGGGGGGGGSSSSSGGGGGGGGGGGGGSSSSSGGGGGGGGGGGGGG
GGGGGGGGGGGGGSSSSSGGGGGGGGGGGGGSSSSSGGGGGGGGGGGGGG
GGGGGGGGGGGGGSSSSSGGGGGGGGGGGGGSSSSSGGGGGGGGGGGGGG
GGGGGGGGGGGGGSSSSSGGGGGGGGGGGGFSSSSSGGGGGGGGGGGGGG
GGGGGGGGGGGGGSSSSSGGGGGGGGGGGGGSSSSSGGGGGGGGGGGGGG
GGGGGGGGGGGGGSSSSSGGGGGGGGGGGGGSSSSSGGGGGGGGGGGGGG
GGGGGGGGGGGGGSSSSSGGGGGGGGGGGGGSSSSSGGGGGGGGGGGGGG
GGGGGGGGGGGGGSSSSSGGGGGGGGGGGGGSSSSSGGGGGGGGGGGGGG
GGGGGGGGGGGGGSSSSSGGGGGGGGGGGGGSSSSSGGGGGGGGGGGGGG
GGGGGGGGGGGGGSSSSSGGGGGGGGGGGGGSSSSSGGGGGGGGGGGGGG
GGGGGGGGGGGGGSSSSSGGGGGGGGGGGGGSSSSSGGGGGGGGGGGGGG
GGGGGGGGGGGGGSSSSSGGGGGGGGGGGGGSSSSSGGGGGGGGGGGGGG
GGGGGGGGGGGGGSSSSSGGGGGGGGGGGGGSSSSSGGGGGGGGGGGGGG
GGGGGGGGGGGGGSSSSSGGGGGGGGGGGGGSSSSSGGGGGGGGGGGGGG
GGGGGGGGGGGGGSSSSSGGGGGGGGGGGGGSSSSSGGGGGGGGGGGGGG
GGGGGGGGGGGGGSSSSSGGGGGGGGGGGGGSSSSSGGGGGGGGGGGGGG
GGGGGGGGGGGGGSSSSSGGGGGGGGGGGGGSSSSSGGGGGGGGGGGGGG
GGGGGGGGGGGGGSSSSSGGGGGGGGGGGGGSSSSSGGGGGGGGGGGGGG